0:Intro:10
~*~
...............
..P............
.....-.........
...............
...............
...O--.---o....
...x......x....
...x......x....
===

1:Multi's:15
~*~
...............
.......-.......
.......-.......
...P--.-.-o....
...x......x....
...x..P...x....
...x......x....
...x......x....
===
END

Empty
---
...............
...............
...............
...............
...............
...............
...............
...............